NO ./tiles/wall/wall_n.png
SO ./tiles/wall/wall_s.png
WE ./tiles/wall/wall_w.png
EA ./tiles/wall/wall_e.png

F 44,42,74
C 36,36,35

11111111111111111111
1A10A000101000101011
1A111110101110101A11
1A1000000A0000000011
1D111111111111100011
100000000WD010100001
10AA0111111010100011
1000001A101010100001
1D1D1D1D1D1D1D111111
1000101010100010D0F1
1110100A001110101111
10101A000000101D1011
101011AA011010101011
1000001000100010A011
11110A01101000111A11
110000000A100000D001
11110000001000111111
1000A00000001AA00011
11111011111011111011
11111111111111111111
