NO ./tiles/wall/wall_n.png
SO ./tiles/wall/wall_s.png
WE ./tiles/wall/wall_w.png
EA ./tiles/wall/wall_e.png

F 44,42,74
C 36,36,35

11111111111111111111111111111111111111111111111111
11010000000101A10001010101000101010001A0000101001
10101111111010101110101010111010101110111110101111
10101010000010101000100000001010101000000000001001
10101011111010101110111111101010101111111111101111
10000N00100010101010000010101000100000101000000011
11111110111010101011111010101000110000101111111011
101A0010100000101010000010101000000000101010000001
10111010111110101011111010101000100000101011111111
100000100000101000000010001A0010000010100000100011
11111011111010100001101110111011111010111110111011
100000000000101000A0001A10100010101000100000000011
11111110000010111011101010111010101110111111100011
101010100000100000101000100A1000100010001010100001
10101A10111011111010111011101110111011101010100011
1010100000100A100010001000100000101000001000000001
101011111011101110111011101111101A1111101111111111
10100010100000101010001010000010000010000010001001
10111010111110101011101011111011110001111011101111
10101010000010101010000010000010A00000100010000011
10101010000010101011111011111011110000111011111011
101000100000000A0000101000A000100000001010000010A1
10111011101111111110101111111011111110101111101111
10100000000A10100010100000101000100010101010101001
10111111110000111010100010101110111010101010101111
10100010000000100000100000001000000010000000101001
10111010000000111000100011101111111011111110101111
100010100000000010001000001010001000001A1010001001
11101011111111101000111110101110111110101011101111
101010A0100A10101000101000101010000010001000000011
10101110111010101110101110101011111011101111111011
100010000010100A0000001010101000000A1A001000000001
111011111010111111111010101011111110111A1111111111
10100010001010101000101000001000001000101010101011
10111011101010101110101111101111101110101010101011
10001000001000001010101000000010101010101000101001
111011111011111A10101011111110101010101A1110101111
10101010000000101010001010000000101010100010101001
10101011111110000011101011111110101010111010101111
1000001000100000A010101000101010101000001000001001
11111011101111000010101110101010101000101111101111
101000000010000010101000001000101000001010000A0011
10111111101000001010111110111010111000101111111011
10000000100000001000101010001000000010100010101011
11111110111010101110101011101000011010111010101011
1A00001000001A100000101000100000001010001010100011
11111011111010111110101110111110101011101010111011
100A00100010001010000A1000000010001000000010001001
111110111011101011111011111110111011111110111011F1
11111111111111111111111111111111111111111111111111
