NO ./tiles/wall/wall_n.png
SO ./tiles/wall/wall_s.png
WE ./tiles/wall/wall_w.png
EA ./tiles/wall/wall_e.png

F 44,42,74
C 36,36,35

11111111111111111111
1S101010101010101011
101010101A1010101011
1D100000000010100A11
10000000011010111011
1000000000001A101011
10000100011010101D11
1010100000100010D011
101A1000001110111A11
101010A0000010100A11
10100001111010111011
1A00000D00101000D001
1111A001101010001111
1010001A101010001001
1011101D101A10001111
10001000000010000011
111D1111111D11111D11
101000100000D0000011
101110111110111110F1
11111111111111111111
