NO ./tiles/wall/wall_n.png
SO ./tiles/wall/wall_s.png
WE ./tiles/wall/wall_w.png
EA ./tiles/wall/wall_e.png

F 44,42,74
C 36,36,35

        1111111111111111111111111
        1000000000110000000000001
        101100A001110000000000001
        100100000000000000A000001
111111111011000001110000000000001
10000000001100000111011111D111111
11110111111111011100000010001
11110111111111011101010010001
110000001101010111000000D0001
10000000000000001100000010001
100000000000A0001101010010001
11000001110101011111011110N0111
11F10111 1110101 101111010001
11111111 1111111 111111111111
