NO ./textures/north_texture.png
SO ./textures/south_texture.png
WE ./textures/west_texture.png
EA ./textures/east_texture.png

F 44,42,74
C 36,36,35


11111
10N01
10001
10001
11D11
100A1
11F11
11111
