NO ./tiles/wall/wall_n.png
SO ./tiles/wall/wall_n.png
WE ./tiles/wall/wall_n.png
EA ./tiles/wall/wall_n.png

F 220,100,0
C 225,30,0

1111111111111111111
1000000000000000001
1000000000000000001
1000000000000000001
1000000001111D10001
1000000001000010001
10000000011D1110001
1000000000000000001
100N000000000000001
1000000000000000001
1111111111111111111