NO ./tiles/wall/wall_n.png
SO ./tiles/wall/wall_n.png
WE ./tiles/wall/wall_n.png
EA ./tiles/wall/wall_n.png

F 220,100,0
C 225,30,0

111111111111
100000000001
100S00000001
100000000001
101111D10001
101000010001
1011D1110001
100000000001
100000000001
100000000001
100000000001
111111111111