NO ./textures/north_texture.png
SO ./textures/south_texture.png
WE ./textures/west_texture.png
EA ./textures/east_texture.png

F      44,42,74
C  36,36,35

1111111111111111111
1000000000000000001
1000000000000000001
1000000000000000001
1000000001111110001
1001000000000000001
1000000001101110001
1000000000000000001
100E000000000100001
1000000000001110001
1111111111111111111
