NO ./tiles/wall/wall_n.png
SO ./tiles/wall/wall_s.png
WE ./tiles/wall/wall_w.png
EA ./tiles/wall/wall_e.png

F      44,42,74
C 36,36,35

1111111111111111111
1000000000000000001
100A000A00000000001
100000000000A000001
1000000001111D10001
100A00000D0A00D0001
10000000011D1110001
1000000000000000001
100E000000000000001
1000000000001F10001
1111111111111111111
