NO ./tiles/wall_n.png
SO ./tiles/wall_s.png
WE ./tiles/wall_w.png
EA ./tiles/wall_e.png

F 220,100,0
C 256,30,0

   111111111111
   1000000N0001
   100000000001
   111111111111