NO ./textures/north_texture.png
SO ./textures/south_texture.png
EA ./textures/east_texture.png
WE ./textures/west_texture.png

F 220,100,0
C 225,30,0

N

11111111
10000001
10000001
100100011
1000000001
100000011
11111111