NO ./textures/north_texture.png
SO ./textures/south_texture.png
EA ./textures/east_texture.png
WE ./textures/west_texture.png

F 220,100,0
C 225,30,0

11111111
10000001
 0000001
10000001
10N00001
10000001
11111111