NO ./tiles/wall/wall_n.png
SO ./tiles/wall/wall_s.png
WE ./tiles/wall/wall_w.png
EA ./tiles/wall/wall_e.png

F 220,-1,0
C 225,30,0

   111111111111
   100000E00001
   100000000001
   111111111111
