NO ./textures/north_texture.png
SO ./textures/south_texture.png
EA ./textures/east_texture.png
WE ./textures/west_texture.png

F 204,204,204
C 153,204,255

11111111
1000011111111   11111111    11111111111
100E000100001   10000000111100000000001
1111000111111   10000000000000000000111
    10001        100000111111111100001
11110001  1111111000001       100000111
10000001 10000000000001 1111  100000111
10000001  111111111111  1001  1000001
10000001                1001  1111111
10010001111111111111111110001
10010000000000000000000000001
10010001111111111111111111111
10011101
1001 101
1111 111