111111111111
100000000001
100000000001
100000000001
100000000001
100000000001
100000000001
100000000001
100000000001
100000000001
100000000001
111111111111


11111111
10000000
10000000
100P0000